grunnsetning	lagfærð_setning	samþykkt	hafnað
1342 átti sér stað mikill borgarbruni í Mechelen.	Árið 1342 varð mikill borgarbruni í Mechelen.	2	0
15 framboð voru í boði, þar af 11 sem bjóða fram á landsvísu.	15 framboð voru í boði, þar af 11 sem buðu fram á landsvísu.	2	0
1803 sótti Napoleon sjálfur borgina heim.	Napoleon sótti sjálfur borgina heim 1803.	2	1
1803 sótti Napoleon sjálfur borgina heim.	Árið 1803 sótti Napoleon sjálfur borgina heim.	5	1
1815 rauf Belgía sig frá konungdæmi Niðurlanda.	1815 reif Belgía sig frá konungdæmi Niðurlanda.	1	0
1830 gerðu Belgar uppreisn og lýstu yfir sjálfstæði.	1830 gerðu Belgar uppreisn og lýstu yfir sjálfstæði sínu.	1	0
200 kílómetrar voru í þann bíl.	200 kílómetrar voru í næsta bíl.	0	1
2010 var Leikfangasaga 3 frumsýnd.	Árið 2010 var Leikfangasaga 3 frumsýnd.	0	1
230 dagar eru eftir af árinu.	Nú/Alls eru 230 dagar eftir af árinu.	0	1
26. Landsmót UMFÍ stendur yfir dagana 9. 12. júlí á Akureyri.	Dagana 9-12. júli stendur yfir 26. Landsmót UMFÍ á Akureyri.	3	4
26. Landsmót UMFÍ stendur yfir dagana 9. 12. júlí á Akureyri.	26. Landsmót UMFÍ stendur yfir dagana 9. til 12. júlí á Akureyri.	4	1
4. til 7. bekkur fór í að reyna að aga börnin til.	4. til 7. bekkur fór í að aga börnin.	1	0
Á annan tug hafa verið teknir undir áhrifum.	Á annan tug hafa verið tekin undir áhrifum.	1	0
Aðeins örfá prósent íbúa Kenía borga nokkurn skatt.	Einugis brot íbúa Kenía greiða skatta	1	0
Að fara á reiðhjól verður vinsælla í London.	Að ferðast á reiðhjóli verður vinsælla í London.	7	0
Á diski 1 eru kaflar 1 - 25 og á diski 2 kaflar 26 - 53 :	Á diski 1 eru kaflar 1 - 25 og á diski 2 eru kaflar 26 - 53 :	1	0
Að menn geti gripið til neyðarréttar.	Menn geta gripið til neyðarréttar.	1	1
Að því búnu lögðu þremenningarnir leið sína í N1 í Hveragerði.	Að svo búnu lögðu þremenningarnir leið sína í N1 í Hveragerði.	2	1
Æfðu þangað til þér líður eins og þú sért að deyja 10.	Æfðu þangað til þér líður eins og þú sért að deyja 10 sinnum.	2	0
Afhverju er hjónaband svona algengt alls staðar í heiminum?	Af hverju er hjónaband svona algengt alls staðar í heiminum?	3	0
Afhverju er þeim sem vilja játast frammi fyrir guði mismunað?	Af hverju er þeim sem vilja játast hvort öðru frammi fyrir Guði mismunað?	1	0
Aftakabylur var og mikill kuldi - 10° til -20° frost.	Það var aftakabylur og -10° til -20° frost.	1	0
Á Íslandi vex engin annar botnþörungur í eins miklu magni.	Enginn annar botnþörungur vex í eins miklu magni á Íslandi.	2	0
Á Íslandi vex engin annar botnþörungur í eins miklu magni.	Á Íslandi vex enginn annar botnþörungur í eins miklu magni.	3	1
Allt frá nýfæddum börnum uppí harðsvíraða glæpamenn.	Allt frá nýfæddum börnum upp í harðsvíraða glæpamenn.	3	2
Allt snýstu um að vinna hina skólana og vera besti skólinn.	Allt snýst um að vinna hina skólana og vera besti skólinn.	1	0
Á næstu árum hófu barnasjónvarpstöðvar sýningar á þættinum.	Á næstu árum hófu barnasjónvarpsstöðvar sýningar á þættinum.	1	0
Anna Mjöll Ólafsdóttir ( fædd 1970 ) er íslensk söngkona.	Anna Mjöll Ólafsdóttir (fædd 1970) er íslensk söngkona.	2	0
Annar hlutinn lifði fékk tækifæri en hinn ekki.	Annar lifði og fékk tækifæri en hinn ekki.	4	1
Á nýlendutíma Spánverja hefur fjallið margoft gosið.	Á nýlendutíma Spánverja gaus fjallið margoft.	4	0
Árið 1430 varð Brabant eign Búrgundar og 1477 Habsborgar.	Árið 1430 varð Brabant eign Búrgundar og árið 1477 eign Habsborgar.	1	0
Árið 1952 dvaldist hún og Magnús í París.	Árið 1952 dvöldust hún og Magnús í París.	1	0
Árin liðu og lokst kom að sjötta bekk.	Árin liðu og loks kom að sjötta bekk.	5	0
Ári seinna kom önnur Dirk Gently bók út.	Ári seinna kom önnur bók Dirk Gently út.	1	0
Á Sansibar eru aftur á móti 99% íbúanna múslimar.	Á Sansibar eru aftur á móti 99% íbúanna múslímar.	0	5
Á sumrin getur hitinn hinsvegar farið yfir 45 gráður.	Á sumrin getur hitinn hins vegar farið yfir 45 gráður.	3	1
Auk þess er væg acetonlykt af andardrættinum og mjólkinni.	Auk þess er væg asetonlykt af andardrættinum og mjólkinni.	2	1
Auk þess sprang, Pollamót og Þjóðhátíð.	Auk þess sprang, pollamót og þjóðhátíð.	0	1
Auk þess sú einfalda staðreynd að fá ferskan markvörð inn.	Auk þess snýst sú einfalda staðreynd um að fá ferskan markvörð inn.	1	0
Auk þess sú einfalda staðreynd að fá ferskan markvörð inn.	Auk þess sú einfalda staðreynd að fá óþreyttan markvörð inn.	2	0
Austraumar náðu að borginni Legazpi og eyðilögðu heil hverfi.	Aurstraumar náðu að borginni Legazpi og eyðilögðu heil hverfi.	1	0
Á veturnar leitar hún í hlýrri sjó í suðurhluta Norðursjávar.	Á veturna leitar hún í hlýrri sjó í suðurhluta Norðursjávar.	3	0
Bílum komið niður á ströndina og svæðið spólað upp.	Bílum var ekið niður á ströndina og svæðið spólað upp.	1	0
Boltinn flýgur áfram á ógnarferð.	Boltinn flýgur áfram á ógnarhraða.	2	0
Botswana er líka eitt af dreifbýlustu löndum heims.	Botswana er einnig eitt af dreifbýlustu löndum heims.	1	0
Brawn bílarnir eru léttari og gæti verið snarpari af stað.	Brawn-bílarnir eru léttari og gætu verið snarpari af stað.	1	0
Breiðablik féll niður í 3. deild.	Breiðablik féll niður í þriðju deild.	2	0
Brönugras hefur fundist allt upp í 2,200 metra hæð.	Brönugras hefur fundist í allt að 2.200 metra hæð.	3	0
Brynjar Þór er með 20 stig fyrir og Lewis 20 fyrir gestina.	Brynjar Þór er með 20 stig fyrir heimaliðið og Lewis 20 fyrir gestina.	1	0
Chas verður öskureiður og eltast við Eli um húsið.	Chas verður öskureiður og elti Eli um húsið.	1	0
Chas verður öskureiður og eltast við Eli um húsið.	Chas verður öskureiður og eltist við Eli um húsið.	1	2
Dæmi um samræmd tákn er t. d. að læra.	Dæmi um samræmt tákn er: „að læra“.	1	0
Dæmi um samræmd tákn er t. d. að læra.	Dæmi um samræmd tákn er að læra.	1	1
Dæmi um svoleiðis hljómsveit voru tildæmis The Monkees.	Dæmi um svoleiðis hljómsveit var The Monkees.	1	1
Dagurinn í dag hafði verið hans dagur.	Dagurinn í dag hefur verið dagurinn hans.	0	1
Deaner sex ára strákur sem verður bráðum sjö ára.	Deaner er sex ára strákur sem verður bráðum sjö ára.	3	2
Draumar fæðast oft jafnvel meðan að maður er enn barn.	Draumar fæðast oft jafnvel á meðan maður er enn barn.	2	0
Drög af frumvarpi verða rædd á ríkisstjórnarfundi í dag.	Drög að frumvarpi verða rædd á ríkisstjórnarfundi í dag.	4	0
Eftir 14 ára skólagöngu er þessu loksins að verða lokið.	14 ára skólagöngu er loksins að verða lokið.	0	1
Eftirminnilegasti fiskurinn?	Hver er eftirminnilegasti fiskurinn?	2	0
Eftir smá stund komu sjúkraliðarnir og lögreglan með.	Eftir smástund komu sjúkraliðarnir og lögreglan með.	0	1
Eftir smá stund komu sjúkraliðarnir og lögreglan með.	Eftir smástund komu sjúkraliðarnir og lögreglan.	3	0
Ef þau væru of veik mætti svæfa þau fyrir fullt.	Ef þau væru of veik mætti svæfa þau fyrir fullt og allt.	4	0
Ég ætla að fjalla um merkasta tímamót í mínu lífi.	Ég ætla að fjalla um merkustu tímamótin í mínu lífi.	2	0
Ég átti ekki vona á sigri um þessa mótshelgi.	Ég átti ekki von á sigri um þessa mótshelgi.	3	0
Eggið klekst út á 7 - 8 dögum eftir frjóvgun.	Eggið klekst út 7 - 8 daga eftir frjóvgun.	2	1
Ég hef ekki ennþá ákveðið mig hvern ég mun aðallega nota.	Ég hef ekki ennþá ákveðið mig hvern ég munï aðallega nota.	1	0
Ég veit ekki afhverju ég þorði ekki að gefa hann upp.	Ég veit ekki af hverju ég þorði ekki að gefa hann upp.	1	1
Ég veit hvað ég myndi gera í annað skipti.	Ég veit hvað ég mundi gera í annað skipti.	1	1
Ein aðferð biblíódrama er biblíólog.	Ein aðferð sagnaspuna er biblíólog.	1	1
Einnig hefur brotist út þetta gríðarlega gsm síma æði.	Einnig hefur brotist út þetta gríðarlega GSM-síma æði.	4	0
Einungsi tíu stig hingað til frá Íslandi í þriðja leikhluta.	Einungis tíu stig hingað til hjá íslenska liðinu í þriðja leikhluta.	2	1
Einungsi tíu stig hingað til frá Íslandi í þriðja leikhluta.	Einungis tíu stig í þriðja leikhluta hingað til frá Íslandi.	2	0
Eitt eiga meðlimirnir sameiginlegt-þeir eru allir fæddir 1979.	Eitt eiga meðlimirnir sameiginlegt: þeir eru allir fæddir 1979.	0	1
Ekkert til í þessu, segir Forstjóri VALITOR.	Ekkert til í þessu, segir forstjóri Valitor	2	0
Ekki frá ríkinu það er alveg á hreinu.	Ekki frá ríkinu, það er alveg á hreinu.	1	0
Ekki nema að Heimsstyrjöldin þriðja skelli á.	Ekki nema að þriðja heimsstyrjöldin skelli á.	1	0
Ekki nema að Heimsstyrjöldin þriðja skelli á.	Ekki nema Heimsstyrjöldin þriðja skelli á.	3	2
Eldaskildagi er þennan dag á Íslandi.	Þennan dag er eldaskildagi á Íslandi.	5	0
Elfstedentocht er líklega eitt þekktasta skautahlaup heims.	eitt þekktasta skautahlaup heims er líklega elfstedentocht	1	0
Elías Már Ómarssonlék á alls oddi og var besti maður vallarins.	Elías Már Ómarsson lék á als oddi og var besti maður vallarins.	5	0
Enda er fyrstu afmæli barns í þeirra augum stærstu tímamótin.	Enda eru fyrstu afmæli barns í þess augum stærstu tímamótin.	0	4
Enda er fyrstu afmæli barns í þeirra augum stærstu tímamótin.	Enda eru fyrstu afmæli barns í þeirra augum stærstu tímamótin.	0	1
Endurbygging borgarinnar tók síðan yfir tíu ár.	Endurbygging borgarinnar tók meira en áratug.	1	0
En eins og með önnur fíkniefni þá éta þau okkur upp að innan.	En eins og önnur fíkniefni éta þau okkur upp að innan.	1	0
En er rétt að taka að framhaldsskólanum?	En er rétt að taka af framhaldsskólanum?	1	0
En hvað vill sjálfur einstaklingurinn gera?	En hvað vill einstaklingurinn sjálfur gera?	2	0
En hver eru helstu rökin með og á móti.	En hver eru helstu rökin með og á móti?	3	0
En launaleynd hlýtur að gera eitthvað gott.	En launaleynd er ekki endilega alslæm.	1	0
Enn aðrir raða orðunum í skringilega röð.	Enn aðrir raða orðunum skringilega.	4	0
En nú er verkið sjálft hinsvegar einnig horfið.	En nú er verkið sjálft hins vegar einnig horfið.	5	1
Er leikurinn var gagnrýndur fékk hann 75 til 89 prósentur.	Er leikurinn var gagnrýndur fékk hann 75 til 89 prósentustig.	2	0
Er það rétt að sýna mynd að þessum manni.	Er það rétt að sýna mynd af þessum manni.	1	0
Er það rétt að sýna mynd að þessum manni.	Er rétt að sýna mynd af þessum manni?	3	0
Er það vonandi merki um auknar göngur í Langá.	Vonandi er það merki um auknar göngur í Langá.	1	0
Er það vonandi merki um auknar göngur í Langá.	Það er vonandi merki um auknar göngur í Langá.	2	1
Er þetta fyrsta loftborna íþróttahúsið á Íslandi.	Þetta er fyrsta loftborna íþróttahúsið á Íslandi.	3	1
Eyjan varð handanhafsumdæmi árið 1946 með umdæmisnúmerið 974.	Eyjan varð að handanhafsumdæmi árið 1946 og hlaut umdæmisnúmerið 974.	2	0
Fáninn var þó ekki formlega tekinn upp fyrr en 1952.	Fáninn var þó ekki formlega tekinn upp fyrr en árið 1952.	1	0
Faxaflói að innanverðu hafi allur verið ísilagður, ein hella.	Faxaflói að innanverðu hafi allur verið ísi lagður, ein hella.	4	1
Félagið er þekkt fyrir að tefla aðeins fram böskum í liði sínu.	Félagið er þekkt fyrir að tefla aðeins fram Böskum í liði sínu.	3	1
Félagið leikur í íslandsmóti karla í íshokkí.	Félagið leikur í Íslandsmóti karla í íshokkí.	3	0
Ferðaþjónusta er einnig vaxandi atvinnugrein.	Ferðaþjónusta er að auki vaxandi atvinnugrein.	0	1
Fifty Shades of Grey er ein vinsælasta bók allra tíma.	Fimmtíu gráir skuggar er ein vinsælasta bók allra tíma.	3	2
Fimmta hvert ár eru hátíðirnar stærri en árin á milli.	Fimmta hvert ár er hátíðin stærri en ella.	0	1
Fimmta hvert ár eru hátíðirnar stærri en árin á milli.	Hátíðirnar er stærri en vanalega fimmta hvert ár.	2	0
Fingrafar Sverrir var þó á málinu.	Fingrafar Sverris var þó á málinu.	3	0
Fisher fæddist í London, Englandi.	Fisher fæddist í London, á Englandi.	1	0
Fjórða stoðin er fastan í ramadan mánuðinum.	Fastan í ramadan mánuðinum er fjórða stoðin.	1	0
Flestir búa í hverfunum Japantown og Little Tokio.	Flestir búa í hverfunum Japantown og Little Tokyo.	1	0
Forsetinn skipar forsætisráðherrann og ríkisstjórnina.	Forseti skipar forsætisráðherra og ríkisstjórn.	1	0
Frásögn þessi er ekki staðfest af neinum samtímaheimildum.	Engar samtímaheimildir hafa staðfest þessa frásögn.	1	0
Frásögn þessi er ekki staðfest af neinum samtímaheimildum.	Engar samtímaheimildir staðfesta þessa frásögn.	1	0
Frá þessu er greint á vef the Washington Post.	Frá þessu er greint á vef The Washington Post.	4	1
Frétt birtist þess efnis birtist á heimasíðu þess í dag.	Frétt um efnið birtist á heimasíðu þess í dag.	1	1
Fyrir þá sem ekki vita hver er Savickas?	Fyrir þá sem ekki vita hver Savickas er?	1	1
Fyrir þá sem ekki vita hver er Savickas?	Fyrir þau sem ekki vita, hver er Savickas?	5	2
Fyrri hálfleikur var stjórnað af KR.	Fyrri hálfleik var stjórnað af KR.	1	0
Fyrsta kvikmyndahlutverk Atkinson var árið 1993 í Free Willy.	Fyrsta kvikmyndahlutverk Atkinsons var árið 1993 í Free Willy.	0	1
Fyrsta kvikmyndahlutverk Danson er í The Onion Field frá 1979.	Fyrsta kvikmyndahlutverk Danson er í kvikmyndeinni The Onion Field frá 1979.	0	4
Fyrsta kvikmyndahlutverk Danson er í The Onion Field frá 1979.	Fyrsta kvikmyndahlutverk Danson er í 'Laukakrinum' frá 1979.	1	0
Fyrsta kvikmyndahlutverk Day var árið 2001 í Strings.	Fyrsta kvikmyndahlutverk Day's var árið 2001 í Strings.	1	0
Fyrsta kvikmyndahlutverk Day var árið 2001 í Strings.	Fyrsta kvikmyndahlutverk Day var í Strings árið 2001.	1	0
Fyrsta plata hennar,, kom út 1996.	Fyrsta plata hennar kom út árið 1996.	4	0
Fyrsta sjónvarpshlutverk Janney var árið 1991 í Morton & Hayes.	Fyrsta sjónvarpshlutverk Janney var í Morton & Hayes árið 1991.	2	0
Gera allt sem manni langar til.	Gera allt sem mann langar til.	1	0
Gerir Dóri þetta til að líkjast hasarmyndahetjunniThe Rock.	Dóri gerir þetta til að líkjast hasarmyndahetjunniThe Rock.	0	2
Gestirnir í vandræðum með sóknarleikinn sinn.	Gestirnir í vandræðum með sóknarleik sinn.	2	1
Geta keypt sér ótal margt sem að manni langar í.	Geta keypt sér ótal margt sem þá langar í.	2	0
Geyminn er hægt að hlaða 280 sinnum	Hægt er að hlaða geyminn 280 sinnum	3	1
Geyminn er hægt að hlaða 280 sinnum	Geyminn er hægt að hlaða 280 sinnum.	4	0
Gínea-Bissá er land í Vestur-Afríku.	Gínea-Bissaú er land í Vestur-Afríku.	0	3
Gjaldmiðillinn, lilangeni, er festur við suðurafríska randið.	Gjaldmiðillinn, lilangeni, er fasttengdur suðurafríska randinu.	1	0
Glæsileg sókn og Keflvíkingar voru með 1 0 forystu í hálfleik.	Glæsileg sókn og Keflvíkingar höfðu 1-0 forystu í hálfleik.	2	0
Gólfið fór að nötra og rauður eldur kveiknar og brennir mig.	Gólfið fór að nötra og rauður eldur kviknar og brennir mig.	3	0
Gosið sést ekki á vefmyndavélum þar sem ský birgja sýn.	Gosið sést ekki á vefmyndavélum þar sem ský byrgja sýn.	5	0
Guð skapar mennina, Guð skapar líka homma og lespíur.	Guð skapar mennina, Guð skapar líka homma og lesbíur.	1	0
Hæðinn upp að þaksperrunni eru 36 metrar.	Hæðin upp að þaksperrunni er 36 metrar.	1	0
Hæsti tindur Gíneu er Nimbafjall 1.752 metra yfir sjávarmáli.	Hæsti tindur Gíneu er Nimbafjall sem er 1.752 metra hár.	1	0
Hæun fer fram á því tungumáli sem er talað á hverjum stað.	Hún fer fram á því tungumáli sem er talað á hverjum stað.	2	0
Handhrærið trönuberin, appelsínubörkin og saltið saman við.	Hrærið trönuberin og appelsínubörkinn, setjið síðan saltið saman við.	0	1
Handhrærið trönuberin, appelsínubörkin og saltið saman við.	Handhrærið trönuberjunum, appelsínuberkinum og saltinu saman.	1	0
Hann er ætlar að kaupa bjór.	Hann ætlar að kaupa bjór.	1	0
Hann er hellst við botninn eða miðsvæðis í sjónum.	Hann er helst við botninn eða miðsvæðis í sjónum.	3	0
Hann er hinsvegar ekki mótfallinn því að selja leikmanninn.	Hann er hins vegar ekki mótfallinn því að selja leikmanninn.	2	0
Hann grátbað þjóðina afsökunar á hörmulegri framistöðu liðsins.	Hann grátbað þjóðina afsökunar á hörmulegri frammistöðu liðsins.	1	0
Hann hafði staðið hinum meginn við netið nánast stjarfklofa.	Hann hafði staðið hinum megin við netið nánast stjarfklofa.	1	0
Hann hefur játað fjöldamorðin.	Hann hefur játað á sig fjöldamorðin.	1	0
Hann hefur játað fjöldamorðin.	Hann hefur játað fjöldamorðið.	2	0
Hann má heldur engann veginn missa af þessu.	Hann má heldur engan veginn missa af þessu.	8	0
Hann sækir um vinnu útum allt.	Hann sækir um vinnu út um allt.	1	0
Hann skrifaði undir samning til 31. janúar 2017 í dag.	Í dag skrifaði hann undir samning sem gildir til 31. janúar 2017.	3	0
Hann skrifar Eli bréf sem segir frá ást sinni fyrir Margot.	Hann skrifar Eli bréf sem segir frá ást hans á Margot.	5	1
Hann spilaði á bandalausan Fender Jazz bass.	Hann spilaði á bandalausan Fender Jazz-bassa.	3	1
Hann vann einnig útgefandi og blaðamaður.	Hann vann einnig sem útgefandi og blaðamaður.	1	0
Hann var þá 24 ára gamall og næstelztur átta systkina.	Hann var þá 24 ára gamall og næstelstur átta systkina.	2	0
Harðlega orðað hjá mér en satt.	Harkalega orðað hjá mér en satt.	1	0
Haukar sigruðu í 2. deild.	Haukar sigruðu 2. deild.	1	4
Hefur mest vigtast 71 kg og hæðsti aldur skráður 30 ára.	Hefur mest vigtast 71 kg og hæsti aldur skráður 30 ára.	1	0
Hefur mest vigtast 71 kg og hæðsti aldur skráður 30 ára.	Hefur mest vegið 71 kg og hæsti aldur skráður 30 ára.	2	0
Heilir mataskar hafa ekki varðveist eldri en frá 19. Öld.	Heilir mataskar hafa ekki varðveist eldri en frá nitjándu öld.	3	1
Heitið finnst þó ekki notað í á prenti fyrr en 1828.	Heitið finnst þó ekki notað á prenti fyrr en 1828.	10	0
Heitið kemur fyrst fyrir í heimildum frá Bandaríkjunum 1716.	Heitið kemur fyrst fyrir í heimildum frá Bandaríkjunum árið 1716.	4	2
Held að hann sé fínn peyji.	Ég held að hann sé fínn peyi.	2	0
Helsta stoð Sádí-Arabíska efnahagsins er útflutningur olíu.	Helsta stoð sádí-arabíska efnahagsins er útflutningur olíu.	3	1
Henni vegnaði vel og seldist hún vel.	Henni vegnaði vel og hún seldi vel.	1	0
Hérmá sjá umfjöllum Telegraph um málið	Hér má sjá umfjöllum Telegraph um málið	1	1
Hérna mun verða fjallað um þetta mál frá ýsmum sjónarhornum.	Hér verður fjallað um þetta mál frá ýsmum sjónarhornum.	2	2
Herstöð er stöð rekin af her og er í eigu hans.	Herstöðinni er sjálfseignarstofnun. 	0	1
Hér þýðir Bergen því árbakki.	Bergen þýðir því hér árbakki.	2	0
Hillupláss hættir ekki að verða verðmætt þótt ríkið eigi það.	Hillupláss missir ekki verðgildi sitt þótt ríkið eigi það.	0	1
Hjarta Bossa Nova stefnunnar er gítarinn.	Kjarni Bossa Nova stefnunnar er gítarinn.	0	1
HK eru með gott lið og spila svipaðan fótbolta og við.	HK er með gott lið og spilar svipaðan fótbolta og við.	6	0
Hraðaupphlaup eftir sjötta varða skot Arons Rafns, 15 - 9.	Eftir sjötta varða skot Arons Rafns kom hraðaupphlaup, staðan er nú 15 - 9.	2	0
Hraði þeirra mældist mest 126 kílómetra á klukkustund.	Hraði þeirra mældist mest 126 kílómetrar á klukkustund.	5	0
Hugvit okkar mannana getur verið skaðlegt náttúrunni.	Hugvit okkar mannanna getur verið skaðlegt náttúrunni.	2	0
Hún er fremur langvaxin rauðbrún á framhlið og hvít á bakhlið.	Hún er fremur langvaxin, rauðbrún á framhlið og hvít á bakhlið.	1	0
Hún er samin af Eiríki Laxdal Eiríkssyni ( 1743 – 1816 ).	Hún er samin af Eiríki Laxdal Eiríkssyni (1743–1816).	1	0
Hún er samin af Eiríki Laxdal Eiríkssyni ( 1743 – 1816 ).	Hún er samin af Eiríki Laxdal Eiríkssyni (1743 – 1816).	4	2
Hún náðu 13. sæti af 25, með 42 stig.	Hún náði 13. sæti af 25, með 42 stig.	3	0
Hún segir söngleikinn í uppáhaldi.	Hún segir söngleikinn vera í uppáhaldi.	3	1
Hún var fyrsta konan til að verða forseti í Brasilíu.	Hún var fyrsta konan sem gegndi embætti forseta í Brasilíu.	2	2
Húsið er 259 fermetrar. Var upprunalega fjós reist árið 1850.	Húsið er 259 fermetrar. Það var upprunalega fjós, sem var reist árið 1850.	1	0
Húsið er 259 fermetrar. Var upprunalega fjós reist árið 1850.	Húsið er 259 fermetrar. Það var upprunalega fjós, reist árið 1850.	5	0
Hvaða breytingar má búast við á næstu árum eða áratugum?	Hvaða breytingum má búast við á næstu árum eða áratugum?	2	0
Hvað ætli maður svo sjái.	Hvað ætli maður sjái svo.	1	0
Hvað er Uppáhalds áin / vatnið þitt?	Hver er Uppáhalds áin / vatnið þitt?	2	1
Hverjir eru uppáhalds veiðistaðirnir þínir?	Hverjir eru eftirlætisveiðistaðirnir þínir?	1	0
Í dag er sjötti bekkur nokkurn veginn búin.	Í dag er sjötti bekkur nokkurn veginn búinn.	5	1
Í Davaó býr fjöldi þjóðabrota, bæði innlendir og erlendir.	Í Davaó býr fjöldi þjóðabrota, bæði innlend og erlend.	1	0
Í eystri sigdalinum eru grunn og afrennslulaus vötn.	Í eystri sigdalnum eru grunn og afrennslislaus vötn.	1	1
Í fjölda landa þurfa atvinnuökumenn sérstök ökuskírteni.	Í fjölda landa þurfa atvinnuökumenn sérstök ökuskírteini.	1	0
Í framhaldi af þvi flautar dómari leiksins leikinn af.	Í framhaldi af því flautar dómarinn leikinn af.	3	0
Í Genk er ein nýtískulegasta Kart-brautin ( Go-Kart ) í Evrópu.	Í Genk er ein nýtískulegasta Kart-braut ( Go-Kart-braut ) í Evrópu.	0	1
Í heiðni trúðu menn á líf eftir dauðan þ. e. framhaldslíf.	Í heiðni trúðu menn á líf eftir dauðann, þ. e. framhaldslíf.	4	0
Í heimstyrjöldinni síðari hertóku nasistar borgina.	Í síðari heimsstyrjöld hertóku nasistar borgina.	0	1
Í heimstyrjöldinni síðari hertóku nasistar borgina.	Nasistar hertóku borgina í heimstyrjöldinni síðari.	1	0
Í Kenía velur folk sér bústað eftir gæðum náttúrunnar.	Í Kenía velur fólk sér bústað eftir gæðum náttúrunnar.	4	0
Í London búa um 8,5 milljónir ( 2013 ).	Í London búa um 8,5 milljónir manna ( árið 2013 ).	3	0
Inn í því eru húsaleigubætur.	Inn í þeirri tölu eru húsaleigubætur.	0	1
iPod touch ( stundum kallaður iTouch ) er tónlistarspilari,.	„IPod touch“ (stundum kallaður „iTouch“) er tónlistarspilari.	0	1
iPod touch ( stundum kallaður iTouch ) er tónlistarspilari,.	iPod touch (stundum kallaður iTouch) er tónlistarspilari.	7	0
Í rauninni sé það ekkert á við það sem þeir áttu von á.	Í rauninni er það ekkert á við það sem þeir áttu von á.	1	0
Íslenskir siðir og menning var ekki til í þeirra orðabók.	Íslenskir siðir og menning voru ekki til í orðabók þeirra.	1	1
Íslenskir siðir og menning var ekki til í þeirra orðabók.	Íslenskir siðir og menning voru ekki til í þeirra orðabók.	3	0
Í upphafi hét fylkið Oversticht ( eða bara Sticht ).	Í upphafi hét fylkið Oversticht (eða bara Sticht).	1	1
Jafnframt var hafnað kröfu um að maðurinn sætti geðrannsókn.	Jafnframt var kröfu um að maðurinn sætti geðrannsókn hafnað.	1	0
Janney lék fréttaritarann og síðan starfsmannstjórann C.	Janney lék fréttaritarann og síðan starfsmannastjórann C.	2	0
Já segja má að framhaldsnám sé mjög mikilvægt í dag.	Já, segja má að framhaldsnám sé mjög mikilvægt í dag.	3	1
Jókertöurnar voru 1, 3, 5, 4 og 0.	Jókertöurnar voru einn, þrír, fimm, fjórir og núll.	0	1
Jón Arnar Magnússon á Íslandsmetið 8 metra slétta.	Jón Arnar Magnússon á Íslandsmetið: 8 metra slétta.	2	0
Jón og unnasta hans rífast öðru hvoru.	Jón og unnasta hans rífast öðru hverju.	0	1
Jón Valgerði hugnast ekki þessar hugmyndir.	Jóni/Jónu og Valgerði hugnast ekki þessar hugmyndir.	1	0
Jú maður sér sjónvarpshandbókina.	Jú, maður sér sjónvarpshandbókina!	1	0
Jú maður sér sjónvarpshandbókina.	Jú, maður sér sjónvarpshandbókina.	4	0
Kaldhæðinn og fjarstæður húmor einkennir myndina.	Kaldhæðinn og fjarstæðukenndur húmor einkennir myndina.	2	0
Kannski að breytingarnar verði ekkert svo miklar.	Ef til vill verða breytingarnar ekki svo miklar.	1	0
Katla er staðsett suðaustan í Mýrdalsjökli.	Katla er staðsett í suðaustanverðum Mýrdalsjökli.	3	0
Keppt var í fimm liða deild og leikin tvöföld umferð.	Keppt var í fimm liða deild þar sem leikið var tvöföld umferð.	0	3
Keppt var í fimm liða deild og leikin tvöföld umferð.	Fimm lið kepptu í deildinni og leiknar voru tvær umferðir	1	0
Kirkjan var vígð árið 1695. Það tók fjórtán ár að byggja hana.	Kirkjan var vígð árið 1695. Bygging hennar tók 14 ár.	4	0
Kjörhitastigið er 25° C – 30° C	Kjörhitastig er 25° C – 30° C	1	0
Kolbrún var kjörin fegurðardrottning Reykjavíkur 1950.	Kolbrún var kjörin fegurðardrottning Reykjavíkur árið 1950.	1	1
Kyle vinnur, að sjálfsögðu, og hann og Jan fagna.	Kyle vinnur að sjálfsögðu og hann og Jan fagna.	1	0
Kyle vinnur, að sjálfsögðu, og hann og Jan fagna.	Að sjálfsögðu vinnur Kyle. Hann og Jan fagna því.	1	0
Lægsti punktur fylkisins er í 2 metra yfir sjávarmáli.	Lægsti punktur fylkisins er 2 m y.s.	1	0
Lagið vann Steinar með upptöku- og pródúserateyminu StopWaitGo.	Lagið vann Steinar með upptöku- og pródúsentateyminu StopWaitGo.	0	2
Landið er að miklu leyti hálent, en láglent við strendur.	Landið er að miklu leyti hálent en láglent við strendur.	5	1
Lando skutlar Kyle að neðstu hæð Skýjaborg í geimskipi sínu.	Lando skutlar Kyle að neðstu hæð Skýjaborgar í geimskipi sínu.	4	0
Landsvæði Bresku Kólumbíu þekur 944,735 km 2.	Landsvæði Bresku Kólumbíu þekur 944.735 ferkílómetra.	5	0
Leikarar reyna að afla jafn mikilla tekna og auðið er.	Leikarar reyna að afla jafn mikilla tekna og unnt er.	1	1
Liðið var í riðli með Sovétríkjunum, Danmörk og Spáni.	Liðið var í riðli með Sovétríkjunum, Danmörku og Spáni.	1	0
líf okkar á ekki að vera endalaust.	líf okkar eiga ekki að vera endalaus.	1	1
Líka upp á hættu að veggirnir og skorsteinninn séu að falla.	Líka upp á hættu á að veggirnir og skorsteinninn falli.	4	0
Loft-og eldflaugaárásir deiluaðila héldu áfram í dag.	Loft- og eldflaugaárásir deiluaðila héldu áfram í dag.	1	0
Löggjafarvald Sádí-Arabíu fylgir Sharia lögum Íslamstrúar.	Löggjafarvald Sádí-Arabíu fylgir Sharia-lögum Íslamstrúar.	1	2
Maður vill nota reynsluna sína til að hjálpa öðrum.	Ég vil nota reynsluna mína til að hjálpa öðrum.	2	1
Maður vill nota reynsluna sína til að hjálpa öðrum.	Maður vill nota reynslu sína til að hjálpa öðrum.	4	0
Mammú og Lay Low hita upp fyrir Of Monsters and Men í kvöld.	Mammút og Lay Low hita upp fyrir Of Monsters and Men í kvöld.	3	0
Manni færri tókst heimamönnum að halda aftan af gestunum.	??????????	0	1
Margir eltast við það að vera betri en náungin.	Margir eltast við það að vera betri en náunginn.	5	0
Margir óttuðust Japana, enda stjórnuðu þeir með grimmd.	Margir óttuðust Japani, enda stjórnuðu þeir með grimmd.	1	0
-Margir vildu nota mann, það er rétt, segir Sigurður.	Margir vildu nota mann, það er rétt, segir Sigurður.	3	2
Mark-aðurinn hrundi 1929 og almenningur tapaði fénu.	Markaðurinn hrundi árið 1929 og almenningur tapaði fé sínu.	1	0
Mark-aðurinn hrundi 1929 og almenningur tapaði fénu.	Markaðurinn hrundi 1929 og almenningur tapaði fénu.	2	0
Markakóngur var Einar Magnússon, Víkingi, með 100 mörk.	Markakóngur var Einar Magnússon, leikmaður Víkings, með 100 mörk.	3	0
Mark Webberer fremstur og Rubens Barrichello við hliði hans.	Mark Webberer fremstur og Rubens Barrichello við hlið hans.	3	0
Meðal annars var ein orsök, hækkun á undirmálslánum.	Meðal annars var hækkun á undirmálslánum ein orsök.	1	0
Menn sjá mikil tækifæri skapast með nýjum samgöngumannvirkjum.	Menn sjá fyrir sér að mikil tækifæri gætu skapast með nýjum samgöngumannvirkjum.	2	0
Mesta frost sem mælst hefur var -16,9° C í april árið 1968.	Mesta frost sem mælst hefur í apríl var -16,9° C árið 1968.	0	1
Mestan samdrátt vil ICES hafa í veiðum á norsk-íslenskri síld.	Mestan samdrátt vill ICES hafa í veiðum á norsk-íslenskri síld.	3	0
Mikið hefur verið rætt um jafnrétti á síðast liðnum árum.	Mikið hefur verið rætt um jafnrétti á síðastliðnum árum.	5	0
Mikill meirihluti íbúa Íraks, eða um 95%, aðhyllast Íslam.	Mikill meirihluti íbúa Íraks, eða um 95%, aðhyllast íslam.	2	2
Mikill munur er á menningu nyrst og syðst í Mozambique.	Mikill munur er á menningu nyrst og syðst í Mósambík.	2	0
Mikil örvænting er á svæðinu.	Mikil örvænting ríkir á svæðinu.	1	0
Miserfitt er að hitta ofaní rennurnar.	Miserfitt er að hitta ofan í rennurnar.	3	0
Mjög mörg mál hafa sömu grunn hugmynd að talningu.	Mjög mörg mál hafa sama grunnhugmynd að talningu.	1	1
Mjög mörg mál hafa sömu grunn hugmynd að talningu.	Mjög mörg mál hafa sömu grunnhugmynd að talningu.	5	0
Mótið náði hápunkti í gær og sóttu um tíu þúsund manns mótið.	Mótið náði hápunkti í gær en alls sóttu það um tíu þúsund manns.	1	0
Mundu bara, stjórnaðu peningunu, ekki láta þá stjórna þér.	Mundu bara, stjórnaðu peningunum, ekki láta þá stjórna þér.	1	1
Mun hann fylla skarð Glen Johnson sem er farinn til Liverpool.	Mun hann fylla skarð Glen Johnson, sem er farinn til Liverpool.	1	1
Nafnið er dregið af arabíska orðinu qibt sem þýðir egypskur.	Nafnið er dregið af arabíska orðinu „qibt“ sem þýðir egypskur.	1	0
Nafnið Írak er dregið af fornaldarborginni Úrúk í Súmer.	Nafnið Írak er dregið af Úrúk, fornaldarborgar í Súmer.	1	0
Nefndin tók hinsvegar ekki fyrir öll mál.	Hinsvegar tók nefndin ekki  fyrir öll mál.	1	1
Neymer segir að draumur hans sé eki á enda.	Neymar segir að draumur hans séu ekki á enda.	1	1
Neymer segir að draumur hans sé eki á enda.	Neymer segir að draumur hans sé ekki á enda.	1	0
Neymer segir að draumur hans sé eki á enda.	Neymer segir að draumur hans sé ekki enn á enda.	1	0
Nico Rosberg, tilkynnti gírkasavandræði á 29. hring.	Nico Rosberg tilkynnti vandræði með gírkassann á 29. hring.	1	0
Nútildags er byggingin notuð sem sýningaraðstaða og skrifstofa.	Núorðið er byggingin notuð fyrir sýningar og sem skrifstofa.	1	0
Nútildags er byggingin notuð sem sýningaraðstaða og skrifstofa.	Nú til dags er byggingin notuð sem sýningaraðstaða og skrifstofa.	2	0
Nútríur eru með stærri nagdýum.	Nútríur eru með stærri nagdýrum.	1	0
Nú var komið að því. Prófraun tveggja leikmanna.	Nú var komið að því: prófraun tveggja leikmanna.	2	0
Ný fjölmiðlalög verða lög fyrir Alþingi í dag.	Ný fjölmiðlalög verða lögð fyrir Alþingi í dag.	2	0
Og ef þú átt allt þetta eða ert þetta þá ertu hamingjusamur.	Ef þú átt allt þetta, eða ert þetta, þá ertu hamingjusamur.	5	0
Og má reikna með að konan verði í skýrslutöku í allan dag.	Reikna má með að konan verði í skýrslutöku í allan dag.	3	0
Ökumenn skiptu þá á sléttu þurr dekkin.	Ökumenn skiptu þá á sléttu þurrdekkin.	3	0
Opinbera tungumálið í Mósambík er Portúglaska.	Opinbera tungumálið í Mósambík er portúgalska.	1	0
Orgelið var byggt árin 1698 – 1700 af Botzon bræðrum.	Orgelið var byggt á árunum 1698 – 1700 af Botzon bræðrum.	1	0
Orkumálastjóra hafi gerð grein fyrir því.	Orkumálastjóra hafi verið gerð grein fyrir því.	5	0
Öröbum er mjög mismunað um allan heim.	Aröbum er mjög mismunað um allan heim.	1	0
Ótrúlegt atvik kláraði leikinn endanlega.	Ótrúlegt atvik gerði útaf endanlega.	0	1
Peninginn geymdi hann í Landsbankanum í formi lífeyrissparnaði.	Peninginn geymdi hann í Landsbankanum í formi lífeyrissparnaðar.	1	0
Píanó er einnig eitt af undirstöðuhljóðfærunum í Bossa Nova.	Þá er píanó einnig eitt af undirstöðuhljóðfærunum í Bossa Nova.	1	0
Plast og ál eigum við líka að endurnota.	.	0	1
Pressuvörn Dana að fara illa með okkar stúlkur þessa stundina.	Pressuvörn Dana er að fara illa með íslenska liðið þessa stundina.	1	0
Red Bull-bíllinn fór betur með dekkin en Ferrari bíll Alonso.	Red Bull-bíllinn fór betur með dekkin en Ferrari-bíll Alonso.	1	1
Rífleg úrkoma eða 1,000 mm er yfir árið.	Rífleg úrkoma, 1.000 mm, er yfir árið.	1	1
Ríkin búa við bráðabirgða stjórnarskrá sem var sett 1972.	Ríkin búa við bráðabirgðastjórnarskrá sem var samþykkt 1972.	1	0
Róleg svo lengi sem ég fékk minn skamt.	Róleg svo lengi sem ég fæ minn skamt.	0	2
RUV segir frá þessu og vitnar í Skessuhorn.	RUV segir frá og vitnar í Skessuhorn.	4	1
Sama ár gaf hann út fyrstu Latabæjar bókina.	Sama ár gaf hann út fyrstu Latabæjarbókina.	1	1
Sam Houston studdi viðbætur við sameinuð ríki Norður Ameríku.	Sam Houston studdi viðbætur við sameinuð ríki Norður-Ameríku.	0	1
Samkunda Fólksins eða Majlis al Shaab er neðri deild þingsins.	Samkunda fólksins eða Majlis al Shaab er neðri deild þingsins.	3	0
Samkvæmt grænlensku reglunum er mönnum bannað að fæða birni.	Samkvæmt grænlensku reglunum er fólki bannað að fóðra birni.	3	0
Samkvæmt vefsíðunni er rífandi gangur á Þórshöfn þessa daganna.	Samkvæmt vefsíðunni er mikil uppbygging á Þórshöfn þessa daganna.	0	1
Sannfæringakraftur hugans nær engum takmörkunum.	Sannfæringakraftur hugans hefur engin takmörk.	8	1
Sá sem fyrstur greindist var faðir barns á leiksskólanum.	Sá sem fyrstur greindist var faðir barns á leikskólanum.	4	0
Seinna kemst Richie á undan frá spítalanum og hittir Margot.	Seinna kemst Richie undan frá spítalanum og hittir Margot.	0	1
Seinna kemst Richie á undan frá spítalanum og hittir Margot.	Seinna sleppur Richie af spítalanum og hittir Margot.	0	1
Seinna meir þá ættleiddu þau stelpu.	þau ættleiddu stelpu seinna meir.	1	2
Seinna meir þá ættleiddu þau stelpu.	Seinna meir ættleiddu þau stelpu.	2	0
Sem dæmi um þetta er hægt að nefna Morgunblaðið og Dv.	Hægt er að nefna Morgunblaðið og DV sem dæmi um þetta.	2	1
Sem dæmi um þetta er hægt að nefna Morgunblaðið og Dv.	Sem dæmi um þetta má nefna Morgunblaðið og DV.	3	0
Sendingar fóru út í bláinn og liðið var fljótt pirrað.	Sendingar fóru út í bláinn og liðið varð fljótt pirrað.	2	0
Sé yndi á lífinu ekki til staðar þá er voðin vís.	Sé yndi á lífinu ekki til staðar þá er voðinn vís.	0	1
Síðan breyttist allt-ég fann ástina í lífi mínu.	Síðan breyttist allt; ég fann ástina í lífi mínu.	0	1
Síðastliðin nótt ágætlega að sögn lögreglu.	Síðastliðin nótt gekk ágætlega að sögn lögreglu.	1	0
Sigmundur segir það aldrei auðvelt að vera brautryðjandi.	Sigmundur segir aldrei auðvelt að vera brautryðjandi.	1	1
Sigríður Hvers vegna telur þú að þú sért vanhæf í þessu máli?	Sigríður, hvers vegna telur þú að þú sért vanhæf í þessu máli?	5	0
Sigrún Lilja er hjá ráðgjafaþjónstu félagsins.	Sigrún Lilja er hjá ráðgjafaþjónustu félagsins.	1	0
Sjóner sögu ríkari.	Sjón er sögu ríkari.	2	0
Skelin þarf að vera mjúk svo hún geti hryngt.	Skelin þarf að vera mjúk svo hún geti hrygnt.	2	0
Skjálftinn fannst vel í Hveragerði og Selfossi.	Skjálftinn fannst vel í Hveragerði og á Selfossi.	1	0
Skólinn rúmar nú 1100 nemendur og samt kvartar engin.	Skólinn rúmar nú 1100 nemendur og enginn engin.	0	5
Skólinn rúmar nú 1100 nemendur og samt kvartar engin.	Skólinn rúmar nú 1100 nemendur og samt kvartar enginn.	2	0
Smá saman tapar boltinn hæð og hann lendir í netinu.	Smám saman tapar boltinn hæð og hann lendir í netinu.	1	0
Söngvarinn gaf út plötuna Paula þann fyrsta júlí síðastliðinn.	Söngvarinn gaf út plötuna Paula hinn fyrsta júlí síðastliðinn.	0	1
Spenging átti sér stað á vinnusvæði við Borgartún 7 rétt áðan.	Spenging varð á vinnusvæði við Borgartún 7 rétt í þessu.	1	1
Stjörnunni tókst svo að gera útum leikinn á 81. mínútu.	Stjörnunni tókst svo að gera út um leikinn á 81. mínútu.	6	0
Stórt svæði eyðilagðist undir 9m þykku öskulagi.	Stórt svæði eyðilagðist undir 9 m þykku öskulagi.	4	0
Stuttmyndin fékk óskarsverðlaun í teiknimyndaflokki.	Stuttmyndin fékk Óskarsverðlaun í teiknimyndaflokki.	2	0
Sunna er það met orðin fljótasta íslenska konan frá upphafi.	Sunna er með því meti orðin fljótasta íslenska konan frá upphafi.	1	0
Sunna er það met orðin fljótasta íslenska konan frá upphafi.	Sunna er  með þessu meti orðin fljótasta íslenska konan frá upphafi.	2	0
Sú umræða hefur raunar verið í gangi lengi.	Sú umræða hefur raunar lengi staðið yfir.	2	0
Svaraðu fyrir þig !	Svaraðu fyrir þig!	3	0
Svo ætla þau út til Ítalíu og klára Masterinn á þremur árum.	Svo ætla þau út til Ítalíu og klára meistaragráðu á þremur árum.	2	0
Svo hef ég alltaf farið í Blöndu og Stóru laxá.	Svo hef ég alltaf farið í Blöndu og Stóru-Laxá.	4	0
Svona snjóhús var notað í aðeins einn eða tvo daga.	Svona snjóhús var aðeins notað í einn eða tvo daga.	1	0
Tablut er leikið á borði með 81 reit eða 9 reitir á hvern kant.	Tablut er leikið á borði með 81 reit eða níu reitum á hverri hlið.	5	1
Tansanía er 31. stærsta land heims.	Tansanía er númer 31 í röð stærstu landa heims.	0	1
Tekju mikil vinna stuðlar að góðum auð.	Tekjumikil vinna stuðlar að góðum auð.	6	1
The Mahavishnu Orchestra spilaði tónlist í rokkaðri kanntinum.	The Mahavishnu Orchestra spilaði tónlist í rokkaðri kantinum.	2	0
The Rasmus er finnsk rokkhljómsveit stofnuð 1994.	The Rasmus er finnsk rokkhljómsveit, stofnuð 1994.	1	0
Thompson fæddist í Richmond, Virginíu.	Thompson fæddist í Richmond í Virginíu.	2	2
Til að glöggva á þessu er gott að stilla upp einföldu dæmi.	Til að glöggva sig á þessu er gott að stilla upp einföldu dæmi.	3	0
Til eru margar gerðir Skuldabréfa sem virka á misjafnan hátt.	Til eru margar gerðir skuldabréfa sem virka á misjafnan hátt.	3	0
Til stóð að reisa höllina á laugardagsmorguninn.	Til stóð að reisa höllina á laugardagsmorgninum.	5	0
Tökum til dæmis samræmt stúdentspróf.	Tökum sem dæmi samræmt stúdentspróf.	1	1
Tónlist er eitt mikilvægasta tjáningaform sem mannkynið hefur.	Tónlist er eitt mikilvægasta tjáningarformið sem mannkynið hefur.	2	1
Tottenham ku einnig hafa verið inni í myndinni hjá Davids.	Tottenham hefur einnig verið inni í myndinni hjá Davids.	1	1
Tvær ástæður geta legið að baki þess.	Tvær ástæður geta legið að baki því.	1	0
Tvígilt járn er leysist vel upp í vatni en þrígilt ekki.	Tvígilt járn leysist vel upp í vatni en þrígilt járn ekki.	2	0
Uggar eru beittir honum til varnar.	Uggum var beitt honum til varnar.	1	1
Um vorið 1945 voru Bandarískar hersveitir komnar til Mindanaó.	Um vorið 1945 voru bandarískar hersveitir komnar til Mindanaó.	2	1
Undir lokin voru svo Fylkismenn æfir og réttilega.	Undir lokin voru Fylkismenn æfir, og það réttilega.	1	0
Væntingarnar voru litlar og liðinu var spáð 5. - 6. sæti.	Væntingarnar voru litlar og liðinu var spáð 5.–6. sæti.	5	0
Valsarar urðu Íslandsmeistarar í karlaflokki og kvennaflokki.	Valsarar urðu Íslandsmeistarar í kvenna- og karlaflokki. 	0	1
Valsstúlkur urðu Íslandsmeistarar í meistaraflokki kvenna.	Valskonur urðu Íslandsmeistarar í meistaraflokki kvenna.	3	2
Varð að endurtaka þau réttarhöld.	Varð að endurtaka réttarhöldin.	2	0
Vegirnir eru númeraðir frá E 1 og uppeftir.	Vegirnir eru númeraðir frá E 1 og uppúr.	3	0
Verið er að þróa nýja gerð rafhlaðna sem kölluð er Power Paper.	Verið er að þróa nýja gerð rafhlaða sem kölluð er Power Paper.	1	0
Verkalýðsfélagið Framsýn ætlar að bjóða upp á kaffi og meððí.	Verkalýðsfélagið Framsýn mun bjóða upp á kaffi og meððí.	1	1
Vestmannaeyjar eru oft notuð sem samheiti yfir Vestmannaeyjabæ.	Vestmannaeyjar er oft notað sem samheiti yfir Vestmannaeyjabæ.	5	0
Viðburðurinn er sjónvarpaður og hefur vakið mikla eftirtekt.	Viðburðinum er sjónvarpað og hefur hann vakið mikla eftirtekt.	1	0
Við erum búin að reyna að selja hver öðrum verðbréf.	Við erum búin að reyna að selja hvert öðru verðbréf.	3	0
Við erum því efstir, lang efstir í fæðukeðjunni.	Við erum því efstir, langefstir, í fæðukeðjunni.	4	0
Við gerðum þetta vel fyrir utan smá vesen til að byrja með.	Við gerðum þetta vel að frátöldu smávegis umstangi í byrjun.	0	1
Við höfum skaða jörðina gífurlega.	Við höfum skaðað jörðina gífurlega.	1	0
Við jarðarbúar höfum mengað mikið frá okkur í gengum tíðina.	Við jarðarbúar höfum mengað mikið í gegnum tíðina.	1	0
Við tekur gríðarleg leit af rétta nashyrningnum.	Við tekur gríðarleg leit að rétta nashyrningnum.	2	0
Við viljum ekki selja best mennina okkar.	Við viljum ekki selja bestu mennina okkar.	4	0
Við vorum alveg að vera komin að Ártúnsbrekkunni.	Við vorum rétt ókomin að Ártúnsbrekkunni.	1	0
Vínbúðirnar er eru eins og aðrar verslanir.	Vínbúðirnar eru eins og aðrar verslanir.	5	0
Von er á hópi ferðamanna í kvöld sem eru að koma að austan.	Von er á hópi ferðamanna að austan í kvöld.	4	0
Vörn íslenska liðsins verið afar góð og Danirnir eiga fá svör.	Vörn íslenska liðsins hefur verið afar góð og Danir áttrið afar góð og Danirnir eiga fá svör.	0	2
Vörn íslenska liðsins verið afar góð og Danirnir eiga fá svör.	Vörn íslenska liðsins hefur verið afar góð og Danirnir eiga fá svör.	2	0
Yfirleitt enda þau í allt öðru starfi en þeim dreymir um.	Yfirleitt enda þau í öðru starfi en þau dreymir um.	1	0
Zoom merkir rönd ( sbr. Saum á þýsku ).	Zoom merkir rönd (sbr. Saum á þýsku).	7	0
Það að kunna að meta það sem að maður hefur það er ómetanlegt.	Það að kunna að meta það sem maður hefur er ómetanlegt.	1	0
Það að kunna að meta það sem að maður hefur það er ómetanlegt.	Það er ómetanlegt að kunna að meta það sem maður hefur.	2	0
Það er áhyggjuefni að enn búa tíu manns á Kópavogshæli.	Það er áhyggjuefni að enn búi tíu manns á Kópavogshæli.	4	0
Það er ekki gott að fólk, né börn fari inn í húsið.	Það er ekki gott að fólk eða börn fari inn í húsið.	1	0
Það er enginn breyting.	Það er engin breyting.	1	0
Það er enn í dag eitt mesta fjöldamorð í hollenskri sögu.	Enn þann dag í dag er þetta mesta fjöldamorð í hollenskri sögu.	1	0
Það er enn í dag eitt mesta fjöldamorð í hollenskri sögu.	Þetta er mesta fjöldamorð í sögu Hollands.	1	0
Það er fimm manneskjur ( í dómnefnd ) sem eru kannski ósamála.	Það eru fimm manneskjur í dómnefnd, sem kannski eru ósamála.	2	3
Það er komið í lok oddalotu í þriðja setti.	Það er komið að lokum oddalotu í þriðja setti.	1	0
Það er lengsta eldgos á Íslandi frá því að sögur hófust.	Það er lengsta eldgos á Íslandi á sögulegum tíma.	2	2
Það er spurning sem aðeins tíminn getur gefið í ljós.	Það er spurning sem aðeins tíminn getur látið í ljós.	2	1
Það eru alltaf breytingar þótt að þær séu litlar.	Það eru alltaf breytingar þó þær séu litlar.	1	0
Það tók kviðdóm hinns vegar aðeins átta mínútur að sýkna hann.	Það tók kviðdóm hins vegar aðeins átta mínútur að sýkna hann.	1	0
Það var svona spurningamerki hvað vð sæjum yfir vetrarmánuðina.	Það var spurning hvað við sæjum yfir vetrarmánuðina.	1	0
Það verður hins vegar ekki litið framhjá ákvörðun van Gaal.	Það verður hinsvegar ekki litið framhjá ákvörðun van Gaal.	0	3
Það þyrfti að vinna að ötulli kennslu í tímatöku.	Það þyrfti að kenna tímatöku vel og vandlega.	2	0
Þá hefur brennisteinslykt fundit af ánum.	Þá hafa árnar lyktað af brennisteinsfnyk.	1	1
Þá hinsvegar tóku FH-ingar aftur við sér og skoruðu annað mark.	Þá tóku FH-ingar hins vegar aftur við sér og skoruðu annað mark.	2	0
Þá hinsvegar tóku FH-ingar aftur við sér og skoruðu annað mark.	Þá tóku FH-ingar aftur við sér og skoruðu annað mark.	2	0
Þang eins og klóþang er víða nytjað til alskonar framleiðslu.	Þang eins og klóþang er víða nytjað til allskonar framleiðslu.	1	1
Þar eiga þeir að leika listir sínar þar á meðal galdra.	Þar eiga þeir að leika listir sínar, þar á meðal galdra.	3	0
Þar má nefna hljómsveitina Wham !	Þar má nefna hljómsveitina Wham!	1	0
Þarmeð áætlar Kyle að fara í Skýjaborg.	Þar með áætlar Kyle að fara í Skýjaborg.	1	0
Þarmeð áætlar Kyle að fara í Skýjaborg.	Þar með áætlar Kyle að fara til Skýjaborgar. 	4	0
Þarna geta peningarnir einnig verið eru stöðutákn.	Þarna geta peningarnir einnig verið stöðutákn.	6	0
Þar segir að talið er að einkaneysla hafi aukist um 1,7%.	Þar segir að talið sé að einkaneysla hafi aukist um 1,7%.	4	0
Þar tapaði liðið fyrir vestur-Þýskalandi í úrslitum.	Þar tapaði liðið fyrir Vestur-Þýskalandi í úrslitum.	3	1
Þátturinn er síðan endursýndur kl. 21 : 45 i kvöld.	Þátturinn er síðan endursýndur kl. 21:45 i kvöld.	4	0
Þau eru föst á sama stað í lífinu og komst ekkert áfram.	Þau eru föst á sama stað í lífinu og komast ekkert áfram.	3	0
Þau hitti hokkí-liðið í bænum og tóku örstuttan leik með þeim.	Þau hitty hokkíliðið í bænum og tóku örstuttan leik með þeim.	0	5
Þau voru hinsvegar heil á húfi, en var illa brugðið.	Þau voru hinsvegar heil á húfi, en þeim var illa brugðið.	3	3
Þá var hins vegar of mikill vindur til verksins.	Þá var hins vegar of mikill vindur til verksins. (Fer eftir samhengi)	0	1
Þeir byrjar hinsvegar nánast aldrei saman inná vellinum.	Þeir byrjar hinsvegar nánast aldrei saman inni á vellinum.	1	0
Þeir byrjar hinsvegar nánast aldrei saman inná vellinum.	Þeir byrja hinsvegar nánast aldrei saman inni á vellinum.	2	0
Þeir eru fyrst og fremst í Oman.	Þeir eru í Oman fyrst og fremst.	1	0
Þeir vakna á sjúkrabeði það sem Ófeigur fagnar þeim vel.	Þeir vakna á sjúkrabeði þar sem Ófeigur fagnar þeim vel.	2	0
Þessi nýi leiðtogi kallaðist Imam.	Nýi leiðtoginn kallaðist Imam.	4	1
Þessum hátíðum fylgja gríðarlegt álag fyrir lögreglunnar.	Þessum hátíðum fylgja gríðarlegt álag fyrir lögregluna.	1	3
Þessum hátíðum fylgja gríðarlegt álag fyrir lögreglunnar.	Þessum hátíðum fylgir gríðarlegt álag fyrir lögregluna.	7	0
Þetta ein skelfilegustu flóð í manna minnum á þessu svæði.	Þetta eru ein skelfilegustu flóð í manna minnum á þessu svæði.	2	0
Þetta er bara slúður af verstu tegund og ekki svaravert.	Þetta er bara slúður af verstu tegund og ekki svara vert.	0	1
Þetta er örlítil lægra hlutfall en á undanförnum tveimur árum.	Þetta er örlítið lægra hlutfall en á undanförnum tveimur árum.	4	0
Þetta er rosalega mikið haltu mér slepptu mér.	Þetta er rosalega mikið haltu-mér-slepptu-mér.	3	1
Þetta eru jú, bestu ár lífsins.	Þetta eru jú bestu ár lífsins.	0	1
Þetta eru jú, bestu ár lífsins.	Þetta eru, jú, bestu ár lífsins.	1	1
Þetta eru svokallaðar MP3 skrár sem að þú getur sókt á netinu.	Þetta eru svokallaðar MP3-skrár sem þú getur sótt á netinu.	2	0
Þetta eru svokallaðar MP3 skrár sem að þú getur sókt á netinu.	Þetta eru svokallaðar MP3 skrár sem þú getur sótt á netinu.	3	0
Þetta er val sem hver verður að svara fyrir sjálfan sig.	Þetta er smekksatriði.	0	1
Þetta hefur legið fyrir í mörg ár?	Hefur þetta legið fyrir í mörg ár?	5	0
Þetta kemur fram á vefsíðu Hagastofunnar.	Þetta kemur fram á vefsíðu Hagstofunnar.	3	0
Þetta kemur fram í tilkynningu frá almannavörnum.	Þetta kemur fram í tilkynningu frá Almannavörnum.	1	0
Þetta lífgar upp á fjölbreytileikann í matmenningu Íslendinga.	Þetta lífgar upp á fjölbreytileikann í matarmenningu Íslendinga.	1	0
Þetta reyndust vera stærsta kolasvæði Belgíu.	Þetta reyndist vera stærsta kolasvæði Belgíu.	2	0
Þetta sagði Assad í viðtali við þýskan fjölmiðilinn ARD í dag.	Þetta sagði Assad í viðtali við þýska fjölmiðilinn ARD í dag.	6	0
Þetta segirRagnar Aðalsteinsson, hæstaréttarlögmaður.	Þetta segir Ragnar Aðalsteinsson, hæstaréttarlögmaður.	4	0
Þetta var árið 1991, en þá var Mustafa sjö ára gamall.	Þetta var árið 1991 en þá var Mustafa sjö ára gamall.	2	1
Þetta voru bæði verslunar, geymslu – og íbúðarhús.	Þetta voru verslunar, geymslu – og íbúðarhús.	4	3
Þetta þýðir á íslensku : æskunni er sóað á hina ungu.	Þetta þýðir á íslensku: æskunni er sóað á hina ungu.	1	1
Þingið getur fellt úr gildi þessi lög.	Þingið getur fellt þessi lög úr gildi.	1	0
Þingið hefur samt í raun enginn völd.	Þingið hefur samt engin völd í raun.	2	0
Þór Akureyri sigraði í 2. deild og tók sæti ÍBK.	Þór, Akureyri sigraði í annari deild og tók sæti ÍBK.	1	0
Þór Vestmannaeyjum féll í 3. deild.	Þór Vestmannaeyjum féll til 3. deildar. 	1	2
Því betur fer er það alls ekki rétt.	Sem betur fer er það alls ekki rétt.	3	0
Því getur samkynhneigði ekki verið andstætt Guðs vilja.	Því getur samkynhneigð ekki verið andstætt Guðs vilja.	0	1
Því næst kom ingvaldur Ásgeirsson með tæpar 14 milljónir.	Næstur kom Ingvaldur Ásgeirsson með tæpar 14 milljónir.	1	0
Því næst kom ingvaldur Ásgeirsson með tæpar 14 milljónir.	Því næst kom Ingvaldur Ásgeirsson með tæpar 14 milljónir.	1	0
Þyrlan lenti síðan í Reykjavík á sjötta tímanum.	Á sjötta tímanum lenti þyrlan síðan í Reykjavík.	0	1
